W W W W W W W W W W W W W W 
W - - - - - - H B B - - - W 
W - O - - C - B - - - E - W 
W - O - C - - B - - - C - W 
W - - - W W W W W H C - - W 
W - - C W - - - W - - C - W 
W - - W W W W W W W - - - W 
W - K C - H H H H - - C - W 
W - C C - H H H H P - - - W 
W W W W W W W W W W W W W W 