W W W W W W W W W W W W W W 
W - - - - - - H - - - - - W 
W - P - - H - - H - H E - W 
W - O - C - - H - - - C - W 
W - - - - O - H - H C - - W 
W - - C - - - - - - - C - W 
W - - C H C - O - - - - - W 
W - K - - - - - - H - B - W 
W - - - - - - - H - - - H W 
W W W W W W W W W W W W W W 