W W W W W W W W W W W W W W 
W - - - - - - H - - - - - W 
W - P - - H - - B - H E - W 
W - O - C - - H - - - C - W 
W - - - - O - H - B C - - W 
W - - C - - - - - - - C - W 
W - - C H C - O - - - - - W 
W - K - - - - - - B - B - W 
W - - - - - - - H - - - H W 
W W W W W W W W W W W W W W 